00b 00b 00b 00b 00b 00b 00b 00b 00b 00b 00b 00b 00b 00b
00a 00a 00a 00a 00a 00a 00a 00a 00a 00a 00a 00a 00a 00b
00a 00w 00a 00w 00a 00w 00a 00w 00a 00w 00a 00a 00a 00b
00a 00a 00a 00a 00a 00a 00a 00a 00a 00a 00w 00a 00a 00b
00a 00w 00a 00a 00a 00a 00a 00a 00a 00a 00a 00a 00a 00b
00a 00a 00a 00a 00a 00a 00a 00a 00a 00a 00w 00a 00a 00b
00a 00w 00a 00a 00a 00a 00a 00a 00a 00a 00a 00a 00a 00b
00a 00a 00a 00a 00a 00a 00a 00a 00a 00b 00w 00a 00a 00b
00a 00w 00a 00w 00a 00w 00a 00w 00a 00w 00b 00a 00a 00b
00a 00a 00a 00a 00a 00a 00a 00a 00a 00a 00a 00a 00a 00b
00a 00a 00a 00a 00a 00a 00a 00a 00a 00a 00a 00a 00a 00b
00b 00b 00b 00b 00b 00a 00a 00b 00b 00b 00b 00b 00b 00b