00a 00a 00a 00a 00a 00b 00a 00b 00a 00a 00a 00a 00a 00a
00a 00a 00a 00a 00a 00b 00a 00b 00a 00a 00a 00a 00a 00a
00a 00a 00a 00a 00a 00b 00a 00b 00a 00a 00a 00a 00a 00a
00a 00a 00a 00a 00a 00b 00a 00b 00a 00a 00a 00a 00a 00a
00b 00b 00b 00b 00b 00b 00a 00b 00b 00b 00b 00b 00b 00b
00a 00a 00a 00a 00a 00a 00a 00a 00a 00a 00a 00a 00a 00a
00b 00b 00b 00b 00b 00b 00a 00b 00b 00b 00b 00b 00b 00b
00a 00a 00a 00a 00a 00b 00a 00b 00a 00a 00a 00a 00a 00a
00a 00a 00a 00a 00a 00b 00a 00b 00a 00a 00a 00a 00a 00a
00a 00a 00a 00a 00a 00b 00a 00b 00a 00a 00a 00a 00a 00a
00a 00a 00a 00a 00a 00b 00a 00b 00a 00a 00a 00a 00a 00a
00a 00a 00a 00a 00a 00b 00a 00b 00a 00a 00a 00a 00a 00a