00w 00w 00a 00a 00a 00a 00a 00a 00a 00a 00a 00a 00a 00a
00w 00w 00a 00w 00w 00w 00w 00w 00w 00w 00w 00w 00w 00w
00w 00w 00a 00a 00a 00w 00a 00a 00a 00w 00w 00w 00w 00w
00w 00w 00w 00w 00a 00w 00a 00w 00a 00w 00w 00w 00w 00w
00a 00a 00a 00a 00a 00w 00a 00w 00a 00w 00w 00w 00w 00w
00a 00w 00w 00w 00w 00w 00a 00w 00a 00w 00a 00a 00a 00a
00a 00w 00a 00a 00a 00a 00a 00w 00a 00w 00a 00w 00a 00a
00a 00a 00a 00w 00w 00w 00w 00w 00a 00w 00a 00w 00w 00w
00w 00w 00w 00w 00a 00a 00a 00a 00a 00w 00a 00w 00w 00w
00w 00a 00a 00a 00a 00w 00w 00w 00w 00w 00a 00w 00w 00w
00w 00a 00w 00w 00w 00w 00w 00w 00w 00w 00a 00w 00w 00w
00w 00a 00a 00a 00a 00a 00a 00a 00a 00a 00a 00w 00w 00w