00a 00a 00a 00a 00a 00a 00a 00a 00a 00a 00a 00a 00a 00a
00w 00w 00w 00w 00w 00w 00c 00c 00w 00c 00w 00a 00w 00w
00w 00w 00w 00w 00w 00w 00c 00c 00w 00c 00a 00a 00w 00w
00w 00w 00w 00w 00w 00a 00c 00c 00w 00c 00w 00a 00w 00w
00b 00b 00b 00b 00b 00b 00c 00c 00b 00b 00b 00a 00b 00b
00b 00a 00a 00a 00a 00a 00c 00c 00a 00a 00a 00a 00a 00b
00b 00a 00a 00a 00a 00a 00a 00a 00a 00a 00a 00a 00a 00b
00b 00a 00a 00a 00a 00a 00a 00a 00a 00a 00a 00a 00a 00b
00b 00a 00a 00a 00a 00a 00a 00a 00a 00a 00a 00a 00a 00b
00b 00a 00a 00a 00a 00a 00a 00a 00a 00a 00a 00a 00a 00b
00b 00a 00a 00a 00a 00a 00a 00a 00a 00a 00a 00a 00a 00b
00b 00a 00a 00a 00a 00a 00a 00a 00a 00a 00a 00a 00a 00b
a00 a00 a0