00b 00a 00b 00a 00a 00a 00a 00b 00b 00a 00b 00a 00a 00a
00a 00b 00a 00b 00a 00b 00a 00b 00a 00a 00b 00b 00a 00b
00b 00a 00a 00a 00a 00b 00b 00a 00b 00a 00a 00a 00a 00a
00a 00a 00b 00a 00a 00a 00b 00b 00b 00a 00b 00b 00a 00a
00b 00a 00b 00a 00b 00b 00a 00a 00b 00a 00b 00a 00a 00a
00a 00a 00b 00a 00a 00b 00b 00a 00b 00a 00b 00b 00a 00b
00a 00b 00b 00b 00a 00a 00a 00b 00b 00a 00b 00b 00b 00b
00a 00a 00a 00b 00a 00b 00b 00a 00a 00a 00a 00b 00a 0bo
00b 00a 00b 00b 00a 00b 00a 00b 00b 00a 00b 00b 00b 00b
00a 00a 00b 00a 00a 00b 00a 00a 00a 00a 00b 00a 00a 00a
00a 00b 00b 00a 00b 00b 00a 00b 00b 00a 00a 00b 00b 00b
00a 00a 00b 00a 00a 00b 00b 00b 00a 00a 00b 00a 00b 00a
a00 a00 a0